 #############
 #...# @ #...#
 #.  # # #  .#
 #           #
 #  ## # ##  #
###### # ######
#   #  #  #   #
# $    #    $ #
# $$#$ # $#$$ #
#   #     #   #
###############


 #######        #######
 #M    #        #    .#
 #     ##########     #
 #                    #
 #  B  ##########     #
 #     #        #     #
 #######        #######


  #############
 #...# M #...#
 #BBB     BBB#
 #           #
 #############
