 #####      ######
 #M  #      #   .#
 #   ########    #
 #               #
 #  B########    #
 #   #      #    #
 #####      ######
